{
    "map": {
        "size": {
                "x": 19,
                "y": 11
        },
        "entities": [
            [ 2,  2,  2,  2,  2,  2,  2,  2,  2,  2,  2,  2,  2,  2,  2,  2,  2,  2,  2],
            [ 2,  0,  0,  0,  0,  0,  0,  0,  0,  0,  0,  0,  0,  0,  0,  0,  0,  0,  2],
            [ 2,  0,  0,  0,  0,  0,  0,  0,  0,  0,  0,  0,  0,  0,  0,  0,  0,  0,  2],
            [ 2,  0,  0,  0,  0,  0,  0,  0,  0,  0,  2,  0,  2,  0,  0,  3,  0,  0,  2],
            [ 2,  0,  0,  0,  0,  0,  0,  0,  0,  2,  2,  0,  2,  2,  0,  0,  0,  0,  2],
            [ 2,  0,  0,  0,  0,  0,  0,  0,  0,  0,  0,  0,  0,  0,  0,  3,  0,  0,  2],
            [21, 28, 28, 28, 28, 28, 21,  2,  2,  2,  2,  0,  2,  2,  2,  2,  2,  0,  2],
            [28,  1,  0,  1,  0,  1, 28,  2,  2,  2,  2,  0,  2,  0,  3,  0,  2,  0,  2],
            [28,  4,  1,  0,  1,  0,  0,  0,  2,  2,  2,  0,  2,  0,  0,  0,  2,  0,  2],
            [28,  1,  4,  1,  0,  1, 28,  0,  0,  0,  0,  0,  0,  0,  0,  0,  2,  0,  2],
            [21, 28, 28, 28, 28, 28, 21,  2,  2,  2,  2,  2,  2,  2,  2,  2,  2,  2,  2]
        ],
        "entities_rotation": [
            [0, 0, 0, 0, 0, 0, 0, 0, 0, 0, 0, 0, 0, 0, 0, 0, 0, 0, 0],
            [0, 0, 0, 0, 0, 0, 0, 0, 0, 0, 0, 0, 0, 0, 0, 0, 0, 0, 0],
            [0, 0, 0, 0, 0, 0, 0, 0, 0, 0, 0, 0, 0, 0, 0, 0, 0, 0, 0],
            [0, 0, 0, 0, 0, 0, 0, 0, 0, 0, 0, 0, 0, 0, 0, 0, 0, 0, 0],
            [0, 0, 0, 0, 0, 0, 0, 0, 0, 0, 0, 0, 0, 0, 0, 0, 0, 0, 0],
            [0, 0, 0, 0, 0, 0, 0, 0, 0, 0, 0, 0, 0, 0, 0, 0, 0, 0, 0],
            [2, 2, 2, 2, 2, 2, 3, 0, 0, 0, 0, 0, 0, 0, 0, 0, 0, 0, 0],
            [1, 0, 0, 0, 0, 0, 3, 0, 0, 0, 0, 0, 0, 0, 0, 0, 0, 0, 0],
            [1, 0, 0, 0, 0, 0, 0, 0, 0, 0, 0, 0, 0, 0, 0, 0, 0, 0, 0],
            [1, 0, 0, 0, 0, 0, 3, 0, 0, 0, 0, 0, 0, 0, 0, 0, 0, 0, 0],
            [1, 0, 0, 0, 0, 0, 4, 0, 0, 0, 0, 0, 0, 0, 0, 0, 0, 0, 0]
        ],
        "img_file": "dnd_bot/assets/maps/map1.png"
    },
    "entity_types": {
        "1": "Player",
        "2": "Rock",
        "3": "Hole",
        "4": "Mushrooms",
        "20": "Dungeon connector",
        "21": "Dungeon corner in",
        "22": "Dungeon corner out",
        "23": "Dungeon crossroads",
        "24": "Dungeon pillar A",
        "25": "Dungeon pillar B",
        "26": "Dungeon pillar C",
        "27": "Dungeon straight A",
        "28": "Dungeon straight B"
    }
}
