{
    "map": {
        "size": {
                "x": 19,
                "y": 11
        },
        "entities": [
            [2, 2, 2, 2, 2, 2, 2, 2, 2, 2, 2, 2, 2, 2, 2, 2, 2, 2, 2],
            [2, 0, 0, 0, 0, 0, 0, 0, 0, 0, 0, 0, 0, 0, 0, 0, 0, 0, 2],
            [2, 0, 0, 0, 0, 0, 0, 0, 0, 0, 0, 0, 0, 0, 0, 0, 0, 0, 2],
            [2, 0, 0, 0, 0, 0, 0, 0, 0, 0, 2, 0, 2, 0, 0, 3, 0, 0, 2],
            [2, 0, 0, 0, 0, 0, 0, 0, 0, 2, 2, 0, 2, 2, 0, 0, 0, 0, 2],
            [2, 0, 0, 0, 0, 0, 0, 0, 0, 0, 0, 0, 0, 0, 0, 3, 0, 0, 2],
            [2, 2, 2, 2, 2, 2, 2, 2, 2, 2, 2, 0, 2, 2, 2, 2, 2, 0, 2],
            [2, 1, 0, 1, 0, 1, 2, 2, 2, 2, 2, 0, 2, 0, 3, 0, 2, 0, 2],
            [2, 4, 1, 0, 1, 0, 0, 0, 2, 2, 2, 0, 2, 0, 0, 0, 2, 0, 2],
            [2, 1, 4, 1, 0, 1, 2, 0, 0, 0, 0, 0, 0, 0, 0, 0, 2, 0, 2],
            [2, 2, 2, 2, 2, 2, 2, 2, 2, 2, 2, 2, 2, 2, 2, 2, 2, 2, 2]
        ],
        "img_file": "dnd_bot/assets/maps/map1.png"
    },
    "entity_types": {
        "1": "Player",
        "2": "Rock",
        "3": "Hole",
        "4": "Mushrooms"
    }
}
