{
    "map": {
        "size": {
                "x": 8,
                "y": 8
        },
        "entities": [
            [ 1, 1, 1, 1, 1, 1, 1, 1 ],
            [ 1, 2, 0, 0, 1, 0, 0, 1 ],
            [ 1, 0, 1, 0, 0, 0, 0, 1 ],
            [ 1, 0, 0, 0, 0, 0, 0, 1 ],
            [ 1, 0, 0, 0, 0, 2, 0, 1 ],
            [ 1, 0, 2, 0, 0, 0, 1, 1 ],
            [ 1, 0, 0, 0, 0, 0, 0, 1 ],
            [ 1, 1, 1, 1, 1, 1, 1, 1 ]
        ]
    },
    "entity_types": {
        "1": "Rock",
        "2": "Hole"
    }
}
