{
    "map": {
        "size": {
                "x": 19,
                "y": 11
        },
        "entities": [
            [1, 1, 1, 1, 1, 1, 1, 1, 1, 1, 1, 1, 1, 1, 1, 1, 1, 1, 1],
            [1, 0, 0, 0, 0, 0, 0, 0, 0, 0, 0, 0, 0, 0, 0, 0, 0, 0, 1],
            [1, 0, 0, 0, 0, 0, 0, 0, 0, 0, 0, 0, 0, 0, 0, 0, 0, 0, 1],
            [1, 0, 0, 0, 0, 0, 0, 0, 0, 0, 1, 0, 1, 0, 0, 2, 0, 0, 1],
            [1, 0, 0, 0, 0, 0, 0, 0, 0, 1, 1, 0, 1, 1, 0, 0, 0, 0, 1],
            [1, 0, 0, 0, 0, 0, 0, 0, 0, 0, 0, 0, 0, 0, 0, 2, 0, 0, 1],
            [1, 1, 1, 1, 1, 1, 1, 1, 1, 1, 1, 0, 1, 1, 1, 1, 1, 0, 1],
            [1, 3, 0, 3, 0, 3, 1, 1, 1, 1, 1, 0, 1, 0, 2, 0, 1, 0, 1],
            [1, 4, 3, 0, 3, 0, 0, 0, 1, 1, 1, 0, 1, 0, 0, 0, 1, 0, 1],
            [1, 3, 4, 3, 0, 3, 1, 0, 0, 0, 0, 0, 0, 0, 0, 0, 1, 0, 1],
            [1, 1, 1, 1, 1, 1, 1, 1, 1, 1, 1, 1, 1, 1, 1, 1, 1, 1, 1]
        ],
        "img_file": "dnd_bot/assets/maps/map1.png"
    },
    "entity_types": {
        "1": "Rock",
        "2": "Hole",
        "3": "Player",
        "4": "Mushrooms"
    }
}
