{
    "map": {
        "size": {
                "x": 20,
                "y": 10
        },
        "entities": [
            [0 , 51, 50, 0 , 0 , 27, 27, 0 , 27, 27, 0 , 0 , 0 , 2 , 0 , 50, 2 , 56, 0 , 0 ],
            [0 , 0 , 0 , 51, 0 , 27, 27, 0 , 27, 21, 22, 0 , 2 , 0 , 0 , 0 , 0 , 0 , 2 , 2 ],
            [50, 0 , 0 , 0 , 51, 22, 22, 0 , 22, 21, 27, 0 , 0 , 0 , 2 , 0 , 2 , 0 , 0 , 0 ],
            [0 , 0 , 0 , 0 , 0 , 0 , 0 , 0 , 0 , 27, 27, 0 , 0 , 0 , 2 , 2 , 0 , 2 , 0 , 54],
            [27, 27, 27, 27, 27, 27, 27, 22, 0 , 27, 27, 0 , 0 , 0 , 0 , 0 , 0 , 2 , 54, 0 ],
            [27, 27, 27, 27, 27, 27, 21, 27, 0 , 27, 27, 0 , 0 , 0 , 0 , 0 , 0 , 0 , 2 , 2 ],
            [1 , 0 , 1 , 0 , 1 , 0 , 0, 22, 0 , 27, 21, 27, 27, 27, 22, 0 , 0 , 0 , 0 , 0 ],
            [0 , 1 , 0 , 1 , 0 , 0 , 0 , 0 , 0 , 22, 27, 27, 27, 27, 22, 0 , 0 , 0 , 4 , 0 ],
            [1 , 0 , 1 , 0 , 1 , 0 , 0, 22, 0 , 0 , 0 , 0 , 0 , 0 , 0 , 0 , 0 , 0 , 0 , 4 ],
            [27, 27, 27, 27, 27, 27, 21, 21, 27, 27, 27, 27, 27, 27, 22, 0 , 0 , 4 , 0 , 4 ]
        ],
        "entities_rotation": [
            [0 , 0 , 0 , 0 , 0 , 3 , 1 , 0 , 3 , 1 , 0 , 0 , 0 , 0 , 0 , 0 , 0 , 0 , 0 , 0 ],
            [0 , 0 , 0 , 0 , 0 , 3 , 1 , 0 , 3 , 1 , 3 , 0 , 0 , 0 , 0 , 0 , 0 , 0 , 0 , 0 ],
            [3 , 0 , 0 , 0 , 0 , 1 , 0 , 0 , 1 , 3 , 1 , 0 , 0 , 0 , 0 , 0 , 0 , 0 , 0 , 0 ],
            [0 , 0 , 0 , 0 , 0 , 0 , 0 , 0 , 0 , 3 , 1 , 0 , 0 , 0 , 0 , 0 , 0 , 0 , 0 , 0 ],
            [0 , 0 , 0 , 0 , 0 , 0 , 0 , 3 , 0 , 3 , 1 , 0 , 0 , 0 , 0 , 0 , 0 , 0 , 0 , 0 ],
            [2 , 2 , 2 , 2 , 2 , 2 , 3 , 1 , 1 , 3 , 1 , 0 , 0 , 0 , 0 , 0 , 0 , 0 , 0 , 0 ],
            [0 , 0 , 0 , 0 , 0 , 0 , 1 , 0 , 0 , 3 , 1 , 0 , 0 , 0 , 3 , 0 , 0 , 0 , 0 , 0 ],
            [0 , 0 , 0 , 0 , 0 , 0 , 0 , 0 , 0 , 1 , 2 , 2 , 2 , 2 , 0 , 0 , 0 , 0 , 0 , 0 ],
            [0 , 0 , 0 , 0 , 0 , 0 , 2 , 3 , 0 , 0 , 0 , 0 , 0 , 0 , 0 , 0 , 0 , 0 , 0 , 0 ],
            [0 , 0 , 0 , 0 , 0 , 0 , 0 , 1 , 0 , 0 , 0 , 0 , 0 , 0 , 3 , 0 , 0 , 0 , 0 , 0 ]
        ],
        "img_file": "dnd_bot/assets/maps/map3.png"
    },
    "entity_types": {
        "1": "Player",
        "2": "Rock",
        "3": "Hole",
        "4": "Mushrooms",
        "20": "Dungeon connector",
        "21": "Dungeon corner in",
        "22": "Dungeon corner out",
        "23": "Dungeon crossroads",
        "24": "Dungeon pillar A",
        "25": "Dungeon pillar B",
        "26": "Dungeon pillar C",
        "27": "Dungeon straight A",
        "28": "Dungeon straight B",
        "50": "Frost mage",
        "51": "Half dragon assassin",
        "54": "Nothic",
        "56": "Skeleton warrior"
    }
}
